1111111111111111111111
1000001000000000000001
100000C000000000000001
1000000000000000000011
11000000000010100000P1
10000000111110100000C1
1000C000000000100000C1
1000000000000000000001
1111111000000000000011
1000000000000011111111
1000C00011111000000001
100000001E000010010001
1111111111111111111111