1111111111111111111111111111111111111111111
1000000000000000000000000000000000000000001
1000000001100100100110000111001000100111001
100000001C00010C1001010000100011C1100101001
100000000110011110011C000010001010100111001
100000000001010010010100001C0010001001C0001
1000000001100100100100100111001000100100001
1P0000000000C000000E00000000000000000000001
1111111111111111111111111111111111111111111